NO ./textures/wood.xpm
SO ./textures/mossy.xpm
WE ./textures/redbrick.xpm
EA ./textures/greystone.xpm

F 105,105,105
C 4,12,77

        1111
 111111100E1
        111