NO ./textures/wood.xpm
SO ./textures/mossy.xpm
WE ./textures/redbrick.xpm
EA ./textures/greystone.xpm

F 105,105,105
C 4,12,77


    111111
   1000001
111100111
1000001
100001
1000S1
111111