NO ./textures/pics/wood.png
SO ./textures/pics/mossy.png
WE ./textures/pics/redbrick.png
EA ./textures/pics/greystone.png

F 105,105,105
C 4,12,77


111111111111111111111111
