NO ./textures/cata_north.xpm
SO ./textures/cata_south.xpm
WE ./textures/cata_west.xpm
EA           ./textures/cata_east.xpm             
F 61     ,45,40        
C  67,67,67 

1111111111111111111111111
1000000000030030000000001
1111111000011110000000001
100000000001  1000S000001
1000000000011110000000001
1111111111111111111111111
